1111111111111111111111111111111111111111111111111111111
10000000000000000000000000000000000000000000000001000C1
1000000000000000000000010101010000000000000000000000101
1000000000000100000000100C00C00000000000000011111100001
1000000000001000000000110000011110100000001111C00101111
1000000101010000C01101001111110000010000000000001100001
100000001C100000010000000001000010100000001000001010101
1000000000100000010010000P01000110000000011110110101001
10000000001110000100100000010111101000000010000C0010101
10000000001000100000111111000C011010000000000000010E001
1000000001000101010010000100000110100000000000000010001
1000000000000011011100100111111110000000000000000001001
100000000000001C010C00100000000000000000000000000000001
1111111111111111111111111111111111111111111111111111111