1111111111111111111111111111111111111
1P00000000110C1C000000000000100000001
1111011111010110111111111010111111101
100001000C010000000000000010000010001
1011110111110111111011111111101011101
1000000000010000010001000000000000001
1111111111011111011101111011111111101
100C000000001000000100000010000000001
1011111011111111111111111010111111101
10000C1000000000C00000000010000010001
1011101111111111011111111110111011101
1000000000000001C00000000000000000001
10111111111111110111111101111101111E1
1000000000010000000000010000010000001
1011111011111111111110111110111111101
1000000000000000010000000010100000001
1111111101101111110111111110111111111
1C000000010000000001000000000000000C1
10C11111111C110101111C1111111111110C1
1111111111111111111111111111111111111
