11111111111111111
1P000010000010001
10111C10101010101
10101110101C10101
10000010101110101
11111010101000101
10001010101011101
10100010101010101
1011101C1010101C1
10101010101010111
10001010101010101
10101000101010101
10101101101000001
10100101C0111C101
10110101101C11101
10E1C100000000001
11111111111111111