1111111111111111111
1000100000101000101
101P101111101110101
10100010000C0010001
1011111010111010111
1010000010001000101
1011101110111011101
1010001000101000001
1010111111101111101
1000100010001000101
1111101010111010101
1010001000000010101
1010101111111010101
1000100000100010001
1110111011111010111
100E001010000010001
1111111111111111111