1111111
1000001
1011101
11CEP11
1011111
1010111
1000001
1111111