01111111111111111111111111110
1000000P000000000000000000001
10000000000000000000000000001
10000000000000000100000000001
10000000000000001000000000001
100000C00000000010C0000000001
100000000000000100000000E0001
10000000000000100000000000001
10000000111111100000000000001
10000000000000000000000000001
10000000000000000000000000001
01111111111111111111111111110
