111111111111111111
101000011111101111
1P0C00011111000110
101000E11111101111
111111111111111111
