11111111111111111111111111111
1000E00000000000000000000000111111111
1111111110000000000000000000000000001
        1P000000000000011111111111111
11111111110000001111111111111
1000C000000000000000000000001
1000000000C000000000000000001
10000000000000000000000000001
11111111111111111111111111111
