11111111111111111111111111111
1000000000000000000000000E001
10000000000000000000000000001
1P000000000000000000000000001
10000000000000000000CC0000001
1000C000000000000000000000001
1000000000000000000000000C001
11111111111111111111111111111

