1111111111111111111111111111111111
1P000000000000000010CCCCCCCCCCCCC1
10000000000C00000010CCCCCCCCCCCCC1
1000000000000E000010CCCCCCCCCCCCC1
10000000000C00000010CCCCCCCCCCCCC1
10000000000C00000010CCCCCCCCCCCCC1
10000000000C00000010CCCCCCCCCCCCC1
10000000000C00000010CCCCCCCCCCCCC1
1111111111111111111111111111111111
