111111111111111111111111111111
110001000000000000000000000001
100000000000C00C00000101000001
100001000100000100000000000111
100001000100000100000000110111
100001000100000100000000000111
100001000100000100000000000111
100001000100000100000000111111
100000000000001E10000100000001
111111111111111111111111111111
