1111111111111111111111111111111111
10P00000C0000000110P00000C00000001
1000000CCC0100001E100000CCC0100001
10000CCCCC111111110000CCCCC1C11111
1000000000000000000000000001000111
1111111111111111111111111111111111
