11111111111111111111
10000P00000000000001
10000C00000000000001
11111111111111111111
